1111111111111011111111111111111111111111111111111111111111111
1111000000000000000000000000111111111111111111111111111111111
1110011111110011111111111110000000000000000000000000000000001
1100110000011010000000000011111111111111111011111111111111101
1001100000000010000000000000000000000000000000000000000000101
1001001111000000000000000000000001111111111111111111111110001
1011001110000010000000000000000000000000000000000000000000101
1010000000000011111111111111111111111111111011111111111111101
1000011110000000000000000000000000000000000000000000000000001
1000011110000011111111111111111111111111111011111111111111101
1010000000000010000000000000000000000000000000000000000000101
1010011110001000000000000000000001111111111111100000000000001
1010001110001010000000000000000000000000000000000000000000101
1010000000001011111111111111111111111111111011111111111111101
1010111100001000000000000000000000000000000000000000000000001
1010111100001011111111111111111111101111111111011111111111101
1010000000001010000000000000000000101000000000000000000000101
1011111111111010000011111100000110000011111111111111111110101
1000000000000010000011111100000110101011111111111111111110101
1011111111111010000011111101010000101000000000000000000000101
1010000000001010000011111101011111101111111111011111111111101
1000000000000010000011111101000000000000000000000000000000001
1010000000001010000011111101011111111111111111011111111111101
1010000000001010000011111101010000000000000000000000000000101
1011111111111010000011111101010111111111111111111111111110101
1000000000000010000011111101010111111111111111111111111110101
1011111111111010000011111101000111111111111111111111111110101
1010000000001010000011111101010000000000000000000000000000101
1010000000001010000000000001011111111111111111111100000000101
1010000000001010000000000001000000000000000000000100111100100
1010000000001010000000000001011111111101111111110100000000101
1000000000000010000000000001010000000101000000010100110000101
1000000000000010000000000001010000000101000000010100000000101
1010000000001011100111111111010000000101000000010100000000101
1010000000001000000000000000010000000101000000010100000000101
1010000000001011111111111111010000000101000000010111110111101
1010000000001010000000000001010000000101000000010000000000001
1010000000001010000001111101010111110101000000010111111111101
1010000000001010000001111101010000000101000000010100000000101
1000000000000010000000000001010000000101000000010100000000101
1010000000001011111011000001011110111101110111110100000000101
1011111111111000000001111111000000000000000000000000000000101
1000000000000011111100000000011111110111111111100000000000101
1011111111111010000101111111010000010100000000101100000001101
1010000000001010000101000001010000010100000000101000000001001
1010000000001010000101000001010000010000000000001000000001011
1010000000001010000101000000000000010100000000101000000001011
1010000000001010000101000001010000010111111111101000000001011
1010000000001010000101000001010000010000000000001000000001011
1011111011111011011101111111011111111101111111111111111111011
1000000000000000000000000000000000000000000000000000000000011
1111111111111111111111111111011111111111111111111111111111111